00000000
0nn00nn0
0nn00nn0
nnnnnnnn
n000000n
nn0000nn
0n0000n0
0nn00nn0
00n00n00
00nnnn00
000nn000
000nn000